R 600 600
NO ./tex/lif.xpm
SO	./tex/war.xpm
WE	./tex/bog.xpm
EA	./tex/eagle.xpm
S							./tex/sale.xpm
F 0,0,0
C 				255,255,255

1111111111111111111111111111
10000000001100000000000000001
10112000011100020000000010001
101220000000000000000N0010001
10112000011100000000000010001
10000000001100000111011110001
11110111111111011100000010001
11110111111111011101010000001
11000000110101011000000000001
10002000000000000000000000001
10000000000000001101010010001
11000000110101011111011110001
11110111111101011111011110001
11111111111111111111111111111